################
#      @    #  #
#           #XX#
#  d        #  #
#              #
#     d        #
#              #
#  d       d   #
#             F#
#    d         #
#              #
#        d     #
#  d           #
#          d   #
#P            P#
################
