################
#      #F#     #
#              #
#   P       @  #
#       d      #
#     s       V#
###          ###
#L     XX     F#
###          ###
#              #
#              #
#   d     dd   #
#   d  V       #
#P            P#
#PP   #L#    PP#
################
